111111111111111111
10000000E000000001
11P10000000C000001
111111111111111111