111111111111111111
10100000P000000001
11110000E000000001
111111111111111111