11111111111111
10P00C00000001
10001111110001
10001000010001
100010E0010001
10001000010001
10001111110001
10000C00000001
10000C00001C11
11111111111111