1111111
100P0C1
10000E1
1111111